matrix input
3 4
1 2 3 4
5 6 7 8
9 10 11 12
matrix sum
3 4
1 2 3 4
5 6 7 8
9 10 11 12
3 4
12 11 10 9
8 7 6 5
4 3 2 1
simple matrix multiply
2 2
2 3
4 5
2 2
-1 2
3 -2
matrix multiply
10 10
-3	-0	-5	-4	1	3	-2	-3	2	3
1	2	2	-4	0	4	-4	1	1	-5
-2	-1	-0	-4	-3	2	-4	-4	4	-4
2	2	4	-2	-2	-3	1	-5	4	-2
-5	4	-1	0	4	-3	4	5	-2	-4
-5	2	-3	5	1	-0	1	-1	2	5
2	-3	-2	-3	-4	-4	4	0	2	1
3	2	2	-1	-2	1	2	3	-1	3
5	3	-3	-0	4	-3	-1	2	-1	-3
2	-5	1	3	-2	-4	1	-2	5	3
10 10
2	-3	-3	-1	-1	4	-3	4	-5	1
-3	-1	-4	-1	-3	-4	3	-4	-3	4
-4	-4	3	0	-1	0	-1	3	-2	3
-1	-1	-5	4	3	2	1	2	-4	-1
-0	1	2	1	4	3	3	2	-0	3
2	4	1	-4	4	-4	-4	4	-1	3
-4	4	2	3	3	-2	-2	-3	-2	3
-3	-3	-3	4	5	-3	3	2	2	-4
1	-1	-1	4	2	4	-0	5	0	2
-4	5	5	4	1	-4	-5	2	3	5
