19 20 2
OOOOOOOOOOOOOOOOOOOO
O%OOOOOOOOOOOOOOOO%O
OOOOOOOOOOOOOOOOOOOO
OOOOOOOOOOOOOOOOOOOO
OOOOOOOOOOOOOOOOOOOO
OOOOOOOOOOOOOOOOOOOO
OOOOOO#######OOOOOOO
OOOOOO#OOOOO#OOOOOOO
OOOOOO#OOOOO#OOOOOOO
OOOOOO#OOAOO#OOOOOOO
OOOOOO#OOOOO#OOOOOOO
OOOOOO#OOOOO#OOOOOOO
OOOOOO#######OOOOOOO
OOOOOOOOOOOOOOOOOOOO
OOOOOOOOOOOOOOOOOOOO
OOOOOOOOOOOOOOOOOOOO
OOOOOOOOOOOOOOOOOOOO
O*OOOOOOOOOOOOOOOO*O
OOOOOOOOOOOOOOOOOOOO
8 10 1 10
12 10 19 10
