20 20 0
OOOOO#OOOOOO#OOOOOOO
OOO#O#OOOO#O#O#####O
OO##O#O#OO#O#O#O%O#O
OOO#O#O#OO#O#OOOOO#O
#OO#O#O#OO#O#######O
OOO#O#O#OO#OOOOOOOOO
OO##O#O#O##########O
OAO#O#O#O#O#OOO#OOOO
OOO#OOO#OOO#OOO#%##O
##########O#O#O#OO#O
OOOOOOOOOOO#O#O#OO#O
OOOOOOOOOOO#O#O#OO#O
OOOOOOOOO%O#O#O#OO#O
OOOOOOOOOOO#O#O#OO#O
OOOOOOOOOOO#O####O#O
OOOOOOOOOOO#OOOOOO#O
OOOOOOOOOOO###O%O##O
OOOOOOOOOOO#OOOOOO#O
OOOOOOOOOOO####O###O
OOOOOOOOOOOOOOOOOOOO
