(OK) matrix input
1	2	3	4
5	6	7	8
9	10	11	12
(OK) matrix sum
13 13 13 13
13 13 13 13
13 13 13 13
(OK) simple matrix multiply
7	-2
11	-2
(OK) matrix multiply
31	60	37	-22	-2	-20	-19	-5	45	23
34	-38	-18	-59	-15	1	17	19	-8	-8
55	-12	6	-52	-39	23	-2	6	15	-13
1	-31	4	-11	-54	39	-7	-5	-31	30
-41	-10	-24	25	27	-27	79	-63	8	-21
-28	51	3	51	28	-26	2	-10	16	28
-2	7	14	25	-15	14	-25	-16	14	-16
-35	-1	2	11	4	-37	-26	9	-11	22
16	-38	-53	-3	-5	36	44	-9	-28	-17
-1	-6	12	56	3	56	-32	41	-2	0
