7 7
#######
#--#-b#
#--#--#
#--#--#
e-----#
#-----#
#######
